[0,0,0,0,0,0,0,0,0,0,0,0,0,0,0,0,0,0,0,0,0,0,0,0,0,0,0,0],
[0,0,0,0,0,0,0,0,0,0,0,0,0,0,0,0,0,0,0,0,0,0,0,0,0,0,0,0],
[0,0,0,0,0,0,0,0,0,0,0,0,0,0,0,0,0,0,0,0,0,0,0,0,0,0,0,0],
[3,4,4,4,4,4,4,4,4,4,4,4,4,5,6,4,4,4,4,4,4,4,4,4,4,4,4,7],
[8,1,1,1,1,1,1,1,1,1,1,1,1,9,10,1,1,1,1,1,1,1,1,1,1,1,1,11],
[8,1,12,13,13,14,1,12,13,13,13,14,1,9,10,1,12,13,13,13,14,1,12,13,13,14,1,11],
[8,2,9,0,0,10,1,9,0,0,0,10,1,9,10,1,9,0,0,0,10,1,9,0,0,10,2,11],
[8,1,15,16,16,17,1,15,16,16,16,17,1,15,17,1,15,16,16,16,17,1,15,16,16,17,1,11],
[8,1,1,1,1,1,1,1,1,1,1,1,1,1,1,1,1,1,1,1,1,1,1,1,1,1,1,11],
[8,1,12,13,13,14,1,12,14,1,12,13,13,13,13,13,13,14,1,12,14,1,12,13,13,14,1,11],
[8,1,15,16,16,17,1,9,10,1,15,16,16,18,19,16,16,17,1,9,10,1,15,16,16,17,1,11],
[8,1,1,1,1,1,1,9,10,1,1,1,1,9,10,1,1,1,1,9,10,1,1,1,1,1,1,11],
[20,21,21,21,21,14,1,9,22,13,13,14,0,9,10,0,12,13,13,23,10,1,12,21,21,21,21,24],
[0,0,0,0,0,8,1,9,19,16,16,17,0,15,17,0,15,16,16,18,10,1,11,0,0,0,0,0],
[0,0,0,0,0,8,1,9,10,0,0,0,0,0,0,0,0,0,0,9,10,1,11,0,0,0,0,0],
[0,0,0,0,0,8,1,9,10,0,25,21,26,27,27,28,21,29,0,9,10,1,11,0,0,0,0,0],
[4,4,4,4,4,17,1,15,17,0,11,0,0,0,0,0,0,8,0,15,17,1,15,4,4,4,4,4],
[0,0,0,0,0,0,1,0,0,0,11,0,0,0,0,0,0,8,0,0,0,1,0,0,0,0,0,0],
[21,21,21,21,21,14,1,12,14,0,11,0,0,0,0,0,0,8,0,12,14,1,12,21,21,21,21,21],
[0,0,0,0,0,8,1,9,10,0,30,4,4,4,4,4,4,31,0,9,10,1,11,0,0,0,0,0],
[0,0,0,0,0,8,1,9,10,0,0,0,0,0,0,0,0,0,0,9,10,1,11,0,0,0,0,0],
[0,0,0,0,0,8,1,9,10,0,12,13,13,13,13,13,13,14,0,9,10,1,11,0,0,0,0,0],
[3,4,4,4,4,17,1,15,17,0,15,16,16,18,19,16,16,17,0,15,17,1,15,4,4,4,4,7],
[8,1,1,1,1,1,1,1,1,1,1,1,1,9,10,1,1,1,1,1,1,1,1,1,1,1,1,11],
[8,1,12,13,13,14,1,12,13,13,13,14,1,9,10,1,12,13,13,13,14,1,12,13,13,14,1,11],
[8,1,15,16,18,10,1,15,16,16,16,17,1,15,17,1,15,16,16,16,17,1,9,19,16,17,1,11],
[8,2,1,1,9,10,1,1,1,1,1,1,1,1,1,1,1,1,1,1,1,1,9,10,1,1,2,11],
[32,13,14,1,9,10,1,12,14,1,12,13,13,13,13,13,13,14,1,12,14,1,9,10,1,12,13,33],
[34,16,17,1,15,17,1,9,10,1,15,16,16,18,19,16,16,17,1,9,10,1,15,17,1,15,16,35],
[8,1,1,1,1,1,1,9,10,1,1,1,1,9,10,1,1,1,1,9,10,1,1,1,1,1,1,11],
[8,1,12,13,13,13,13,23,22,13,13,14,1,9,10,1,12,13,13,23,22,13,13,13,13,14,1,11],
[8,1,15,16,16,16,16,16,16,16,16,17,1,15,17,1,15,16,16,16,16,16,16,16,16,17,1,11],
[8,1,1,1,1,1,1,1,1,1,1,1,1,1,1,1,1,1,1,1,1,1,1,1,1,1,1,11],
[20,21,21,21,21,21,21,21,21,21,21,21,21,21,21,21,21,21,21,21,21,21,21,21,21,21,21,24],
[0,0,0,0,0,0,0,0,0,0,0,0,0,0,0,0,0,0,0,0,0,0,0,0,0,0,0,0],
[0,0,0,0,0,0,0,0,0,0,0,0,0,0,0,0,0,0,0,0,0,0,0,0,0,0,0,0]